1111111111111111111111111111111
10000P100N00010000100000000CC01
101111101110100110001111C001101
100001101110C011101N11111100001
1011000C10001N000010111E0001111
1C00011000111110100C10C01000001
1001000010000000110000100111001
110001100011N100000111N10010001
1000C00000C000C000C0000C000C111
1C00011N00111110100C10C01N0C1N1
100100001000000011000010000C111
110001100011N10000011111010C1N1
1000C00000C000C000C0000C00CC111
10010000100000001100001010CN001
11000110001NN100000111110011101
1000C00000C000C000C0000C00CC001
1111111111111111111111111111111
