11111111111111111111111
1PEC0C000C00C00C00C00C1
10NNN0000000NNN0000NN01
1CNN0N00000N0NN000NNNC1
10NN00N000N00NN00N0NN01
1CNN000N0N000NN0000NNC1
10NN0000N0000NN0000NN01
10C00C00C00C00C00C00C01
11111111111111111111111
