111111111111
1000000P00E1
111011111001
1C0000110011
101110110111
1000001C0111
111111111111
